; level_02 - L-turn
; teaches turning. hit the wall, try down
steps: 20
start_dir: right
########################
#@..................#..#
#...................#..#
#...................#..#
#...................*..#
#......................
#.......down#########..#
########################