; tutorial_04 - preplaced char
steps: 14
start_dir: right
################
#######9...9..9#
#######.######.#
#######.######.#
#######.######.#
#######.######.#
@......b......9#
#######.######.#
#######.######.#
#######.######.#
#######.######.#
#######.######.#
#######.######.#
#######.######.#
#######*......6#
################
