; tutorial_03 - step bonus
; not enough steps to reach goal directly, collect 9 below
steps: 10
start_dir: right
##########################
#@..........*............#
#........................#
#........9...............#
#........................#
#........................#
#..........8.............#
##########################
